ace	ace_Latn_ID	ace
af	afr_Latn_ZA	afr
ak	aka_Latn_GH	aka
am	amh_Ethi_ET	amh
ar	ara_Arab_XX	ara
as	asm_Beng_IN	asm
ast	ast_Latn_ES	ast
awa	awa_Deva_IN	awa
ay	aym_Latn_BO	aym
az	aze_Latn_XX	aze_Latn
az_Arab	aze_Arab_IR	aze_Arab
ba	bak_Cyrl_RU	bak
ban	ban_Latn_ID	ban
be	bel_Cyrl_BY	bel
bem	bem_Latn_ZM	bem
bg	bul_Cyrl_BG	bul
bho	bho_Deva_XX	bho
bjn	bjn_Latn_ID	bjn
bm	bam_Latn_ML	bam_Latn
bn	ben_Beng_BD	ben
bo	bod_Tibt_CN	bod
bs	bos_Latn_BA	bos_Latn
bug	bug_Latn_ID	bug
ca	cat_Latn_ES	cat
ceb	ceb_Latn_PH	ceb
cjk	cjk_Latn_XX	cjk_Latn
crh	crh_Cyrl_XX	crh
cs	ces_Latn_CZ	ces
cy	cym_Latn_GB	cym
da	dan_Latn_DK	dan
de	deu_Latn_DE	deu
dik	dik_Latn_XX	dik
diq	diq_Latn_TR	diq
dyu	dyu_Latn_BF	dyu
dz	dzo_Tibt_BT	dzo
ee	ewe_Latn_GH	ewe
el	ell_Grek_GR	ell
en	eng_Latn_US	eng
eo	epo_Latn_XX	epo
es	spa_Latn_ES	spa
et	est_Latn_EE	est
fa	fas_Arab_IR	fas
ff	ful_Latn_XX	ful
fi	fin_Latn_FI	fin
fj	fij_Latn_FJ	fij
fo	fao_Latn_FO	fao
fon	fon_Latn_BJ	fon
fr	fra_Latn_FR	fra
fur	fur_Latn_IT	fur
ga	gle_Latn_IE	gle
gd	gla_Latn_GB	gla
gl	glg_Latn_ES	glg
gn	grn_Latn_PY	grn
gu	guj_Gujr_IN	guj
ha	hau_Latn_NG	hau_Latn
he	heb_Hebr_IL	heb
hi	hin_Deva_IN	hin
hne	hne_Deva_IN	hne
hr	hrv_Latn_HR	hrv
ht	hat_Latn_HT	hat
hu	hun_Latn_HU	hun
hy	hye_Armn_AM	hye
id	ind_Latn_ID	ind
ig	ibo_Latn_NG	ibo
ilo	ilo_Latn_PH	ilo
is	isl_Latn_IS	isl
it	ita_Latn_IT	ita
ja	jpn_Jpan_JP	jpn
jv	jav_Latn_ID	jav
ka	kat_Geor_GE	kat
kab	kab_Latn_DZ	kab
kac	kac_Latn_XX	kac
kam	kam_Latn_KE	kam
kbp	kbp_Latn_XX	kbp_Latn
kea	kea_Latn_CV	kea
kg	kon_Latn_CD	kon
ki	kik_Latn_KE	kik
kk	kaz_Cyrl_KZ	kaz_Cyrl
km	khm_Khmr_KH	khm
kmb	kmb_Latn_AO	kmb
kn	kan_Knda_IN	kan
ko	kor_Zyyy_KR	kor
kr_Arab	kau_Zyyy_XX	kau
kr_Latn	kau_Latn_XX	kau
ks_Arab	kas_Arab_IN	kas_Arab
ks_Deva	kas_Deva_IN	kas_Deva
ku_Arab	ckb_Arab_IQ	ckb
ku_Latn	kmr_Latn_TR	kmr
ky	kir_Cyrl_KG	kir_Cyrl
lb	ltz_Latn_LU	ltz
lg	lug_Latn_UG	lug
li	lim_Latn_XX	lim
lij	lij_Latn_XX	lij
lmo	lmo_Latn_XX	lmo
ln	lin_Latn_CD	lin
lo	lao_Laoo_LA	lao
lt	lit_Latn_LT	lit
ltg	ltg_Latn_LV	ltg
lua	lua_Latn_CD	lua
luo	luo_Latn_KE	luo
lus	lus_Zyyy_XX	lus
lv	lav_Latn_LV	lav
mag	mag_Deva_IN	mag
mai	mai_Deva_IN	mai
mg	mlg_Latn_MG	mlg
mi	mri_Latn_NZ	mri
min	min_Latn_ID	min
mk	mkd_Cyrl_MK	mkd
ml	mal_Mlym_IN	mal
mn	mon_Cyrl_MN	mon
mni	mni_Beng_IN	mni
mos	mos_Latn_BF	mos
mr	mar_Deva_IN	mar
ms	msa_Latn_MY	msa_Latn
mt	mlt_Latn_MT	mlt
my	mya_Mymr_MM	mya
ne	nep_Deva_NP	nep
nl	nld_Latn_NL	nld
no	nor_Latn_NO	nor
nso	nso_Latn_ZA	nso
nus	nus_Latn_SS	nus
ny	nya_Latn_MW	nya
oc	oci_Latn_FR	oci
om	orm_Latn_ET	orm
or	ori_Orya_IN	ori
pa	pan_Guru_XX	pan_Guru
pag	pag_Latn_PH	pag
pap	pap_Latn_XX	pap
pl	pol_Latn_PL	pol
prs	prs_Arab_IR	prs
ps	pus_Arab_AF	pus
pt	por_Latn_PT	por
qu	que_Latn_PE	que
rn	run_Latn_BI	run
ro	ron_Latn_RO	ron
ru	rus_Cyrl_RU	rus
rw	kin_Latn_RW	kin
sa	san_Deva_IN	san_Deva
sat	sat_Olck_IN	sat
sc	srd_Latn_IT	srd
scn	scn_Latn_IT	scn
sd	snd_Arab_XX	snd_Arab
sg	sag_Latn_CF	sag
shn	shn_Mymr_MM	shn
si	sin_Sinh_LK	sin
sk	slk_Latn_SK	slk
sl	slv_Latn_SI	slv
sm	smo_Latn_XX	smo
sn	sna_Latn_ZW	sna
so	som_Latn_SO	som
sq	sqi_Latn_AL	sqi
sr	srp_Latn_XX	srp_Latn
ss	ssw_Latn_ZA	ssw
st	sot_Latn_ZA	sot
su	sun_Latn_ID	sun
sv	swe_Latn_SE	swe
sw	swa_Latn_TZ	swa
szl	szl_Latn_PL	szl
ta	tam_Taml_IN	tam
taq	taq_Latn_NE	taq
te	tel_Telu_IN	tel
tg	tgk_Cyrl_TJ	tgk_Cyrl
ti	tir_Ethi_ET	tir
tk	tuk_Arab_TM	tuk_Arab
tl	tgl_Latn_XX	tgl_Latn
tn	tsn_Latn_ZA	tsn
tpi	tpi_Latn_PG	tpi
tr	tur_Latn_TR	tur
ts	tso_Latn_ZA	tso
tt	tat_Cyrl_RU	tat
tum	tum_Latn_MW	tum
tw	twi_Latn_GH	twi
tzm	tzm_Tfng_MA	tzm_Tfng
ug	uig_Arab_CN	uig_Arab
uk	ukr_Cyrl_UA	ukr
umb	umb_Latn_AO	umb
ur	urd_Arab_PK	urd
uz	uzb_Latn_XX	uzb_Latn
vec	vec_Latn_XX	vec
vi	vie_Latn_VN	vie
war	war_Latn_PH	war
wo	wol_Latn_SN	wol
xh	xho_Latn_ZA	xho
yi	yid_Hebr_XX	yid
yo	yor_Latn_NG	yor
zh	zho_Hans_XX	zho_Hans
zh_TW	zho_Hans_TW	zho_Hans_TW
zu	zul_Latn_ZA	zul
