ab	abk_Cyrl_GE	abk
acm	acm_Arab_XX	acm
ady	ady_Cyrl_RU	ady
af	afr_Latn_ZA	afr
afb	afb_Arab_XX	afb
afh	afh_Latn_XX	afh_Latn
aii	aii_Syrc_IQ	aii_Syrc
ain	ain_Kana_XX	ain_Kana
ajp	ajp_Arab_XX	ajp
akl	akl_Latn_XX	akl_Latn
aln	aln_Latn_XK	aln
alt	alt_Cyrl_XX	alt
am	amh_Ethi_ET	amh
an	arg_Latn_ES	arg
ang	ang_Latn_XX	ang_Latn
aoz	aoz_Latn_XX	aoz
apc	apc_Arab_XX	apc
ar	ara_Arab_XX	ara
arq	arq_Arab_DZ	arq
ary	ary_Arab_MA	ary
arz	arz_Arab_EG	arz
as	asm_Beng_IN	asm
ast	ast_Latn_ES	ast
avk	avk_Latn_XX	avk_Latn
awa	awa_Deva_IN	awa
ay	aym_Latn_BO	aym
ayl	ayl_Arab_XX	ayl
az	aze_Latn_XX	aze_Latn
ba	bak_Cyrl_RU	bak
bal	bal_Arab_XX	bal
ban	ban_Latn_ID	ban
bar	bar_Latn_XX	bar
bcl	bcl_Latn_PH	bcl
be	bel_Cyrl_BY	bel
ber	ber_Latn_XX	ber_Latn
bfz	bfz_Taml_XX	bfz_Sinh
bg	bul_Cyrl_BG	bul
bho	bho_Deva_XX	bho
bi	bis_Latn_VU	bis
bjn	bjn_Latn_ID	bjn
bm	bam_Latn_ML	bam_Latn
bn	ben_Beng_BD	ben
bo	bod_Tibt_CN	bod
br	bre_Latn_FR	bre
brx	brx_Deva_IN	brx
bs	bos_Latn_BA	bos_Latn
bua	bua_Cyrl_XX	bua
bvy	bvy_Latn_XX	bvy_Latn
bzt	bzt_Latn_XX	bzt_Latn
ca	cat_Latn_ES	cat
cay	cay_Latn_XX	cay
cbk	cbk_Latn_XX	cbk_Latn
ce	che_Cyrl_RU	che
ceb	ceb_Latn_PH	ceb
ch	cha_Latn_GU	cha
chg	chg_Latn_XX	chg_Arab
chn	chn_Latn_XX	chn_Latn
cho	cho_Latn_XX	cho
chr	chr_Cher_US	chr
cjy	cjy_Hans_XX	cjy_Hans
ckb	ckb_Arab_IQ	ckb
ckt	ckt_Cyrl_XX	ckt
cmn	cmn_Hans_XX	cmn_Hans
cmo	cmo_Khmr_XX	cmo_Khmr
co	cos_Latn_FR	cos
cpi	cpi_Latn_XX	cpi_Latn
crh	crh_Zyyy_XX	crh
crk	crk_Cans_XX	crk
crs	crs_Latn_SC	crs
cs	ces_Latn_CZ	ces
csb	csb_Latn_PL	csb_Latn
cv	chv_Cyrl_RU	chv
cy	cym_Latn_GB	cym
cycl	cycl_Latn_XX	cycl_Latn
cyo	cyo_Latn_XX	cyo_Latn
da	dan_Latn_DK	dan
de	deu_Latn_DE	deu
diq	diq_Latn_TR	diq
dng	dng_Cyrl_XX	dng
drt	drt_Latn_XX	drt_Latn
dsb	dsb_Latn_DE	dsb
dtp	dtp_Latn_XX	dtp
dv	div_Thaa_MV	div
dws	dws_Latn_XX	dws_Latn
ee	ewe_Latn_GH	ewe
egl	egl_Latn_XX	egl
el	ell_Grek_GR	ell
emx	emx_Latn_XX	emx_Latn
en	eng_Latn_US	eng
enm	enm_Latn_XX	enm_Latn
eo	epo_Latn_XX	epo
es	spa_Latn_ES	spa
et	est_Latn_EE	est
eu	eus_Latn_ES	eus
evn	evn_Cyrl_XX	evn
ext	ext_Latn_XX	ext
fi	fin_Latn_FI	fin
fj	fij_Latn_FJ	fij
fkv	fkv_Latn_XX	fkv_Latn
fo	fao_Latn_FO	fao
fr	fra_Latn_FR	fra
frm	frm_Latn_XX	frm_Latn
fro	fro_Latn_XX	fro_Latn
frr	frr_Latn_XX	frr
fuc	fuc_Latn_XX	fuc
fur	fur_Latn_IT	fur
fuv	fuv_Latn_NG	fuv
fy	fry_Latn_NL	fry
ga	gle_Latn_IE	gle
gaa	gaa_Latn_GH	gaa
gag	gag_Latn_XX	gag
gan	gan_Hans_CN	gan
gbm	gbm_Deva_IN	gbm
gcf	gcf_Latn_XX	gcf_Latn
gd	gla_Latn_GB	gla
gil	gil_Latn_KI	gil
gl	glg_Latn_ES	glg
gn	grn_Latn_PY	grn
gom	gom_Deva_IN	gom
gos	gos_Latn_XX	gos
got	got_Goth_XX	got_Goth
grc	grc_Grek_XX	grc_Grek
gsw	gsw_Latn_CH	gsw
gu	guj_Gujr_IN	guj
gv	glv_Latn_IM	glv
ha	hau_Latn_NG	hau_Latn
hak	hak_Hans_CN	hak
haw	haw_Latn_US	haw
hax	hax_Latn_XX	hax
hbo	hbo_Hebr_XX	hbo_Hebr
hdn	hdn_Latn_XX	hdn
he	heb_Hebr_IL	heb
hi	hin_Deva_IN	hin
hif	hif_Latn_FJ	hif_Latn
hil	hil_Latn_PH	hil
hnj	hnj_Zyyy_XX	hnj
hoc	hoc_Zyyy_IN	hoc
hr	hrv_Latn_HR	hrv
hrx	hrx_Latn_XX	hrx_Latn
hsb	hsb_Latn_DE	hsb
hsn	hsn_Hans_CN	hsn
ht	hat_Latn_HT	hat
hu	hun_Latn_HU	hun
hy	hye_Armn_AM	hye
ia	ina_Latn_XX	ina_Latn
iba	iba_Latn_XX	iba
id	ind_Latn_ID	ind
ie	ile_Latn_XX	ile_Latn
ig	ibo_Latn_NG	ibo
ii	iii_Yiii_CN	iii
ike	ike_Latn_CA	ike_Latn
ilo	ilo_Latn_PH	ilo
io	ido_Latn_XX	ido_Latn
is	isl_Latn_IS	isl
it	ita_Latn_IT	ita
izh	izh_Latn_XX	izh
ja	jpn_Jpan_JP	jpn
jam	jam_Latn_JM	jam
jbo	jbo_Latn_XX	jbo_Latn
jdt	jdt_Cyrl_XX	jdt_Cyrl
jpa	jpa_Hebr_XX	jpa_Hebr
jv	jav_Latn_ID	jav
ka	kat_Geor_GE	kat
kaa	kaa_Cyrl_XX	kaa
kab	kab_Latn_DZ	kab
kam	kam_Latn_KE	kam
kek	kek_Latn_XX	kek_Latn
kha	kha_Latn_IN	kha
kiu	kiu_Latn_TR	kiu
kjh	kjh_Cyrl_XX	kjh
kk	kaz_Zyyy_KZ	kaz
kl	kal_Latn_GL	kal
km	khm_Khmr_KH	khm
kmr	kmr_Latn_TR	kmr
kn	kan_Knda_IN	kan
ko	kor_Zyyy_KR	kor
koi	koi_Cyrl_RU	koi
kpv	kpv_Cyrl_RU	kpv
krc	krc_Cyrl_RU	krc
krl	krl_Latn_XX	krl
ks	kas_Arab_IN	kas_Arab
ksh	ksh_Latn_DE	ksh
ku	kmr_Latn_TR	kmr
kum	kum_Cyrl_RU	kum
kw	cor_Latn_GB	cor
kxi	kxi_Latn_XX	kxi_Latn
ky	kir_Cyrl_KG	kir_Cyrl
kzj	kzj_Latn_XX	kzj_Latn
la	lat_Latn_VA	lat_Latn
laa	laa_Latn_XX	laa_Latn
lad	lad_Hebr_XX	lad
lb	ltz_Latn_LU	ltz
ldn	ldn_Latn_XX	ldn_Latn
lfn	lfn_Latn_XX	lfn_Latn
lg	lug_Latn_UG	lug
lij	lij_Latn_XX	lij
liv	liv_Latn_XX	liv_Latn
lkt	lkt_Latn_US	lkt
lld	lld_Latn_XX	lld_Latn
lmo	lmo_Latn_XX	lmo
ln	lin_Latn_CD	lin
lo	lao_Laoo_LA	lao
lou	lou_Latn_XX	lou_Latn
lt	lit_Latn_LT	lit
ltg	ltg_Latn_LV	ltg
lut	lut_Latn_XX	lut_Latn
lv	lav_Latn_LV	lav
lzh	lzh_Hans_XX	lzh_Hans
lzz	lzz_Geor_XX	lzz_Geor
mad	mad_Latn_ID	mad
mai	mai_Deva_IN	mai
max	max_Latn_MY	max_Latn
mdf	mdf_Cyrl_RU	mdf
mfe	mfe_Latn_MU	mfe
mg	mlg_Latn_MG	mlg
mgm	mgm_Latn_XX	mgm_Latn
mh	mah_Latn_MH	mah
mhr	mhr_Cyrl_XX	mhr
mi	mri_Latn_NZ	mri
mic	mic_Latn_XX	mic
min	min_Latn_ID	min
mk	mkd_Cyrl_MK	mkd
ml	mal_Mlym_IN	mal
mn	mon_Cyrl_MN	mon
mnc	mnc_Mong_XX	mnc_Mong
mni	mni_Zyyy_IN	mni
mnw	mnw_Mymr_XX	mnw
moh	moh_Latn_CA	moh
mr	mar_Deva_IN	mar
mrj	mrj_Cyrl_XX	mrj
mt	mlt_Latn_MT	mlt
mvv	mvv_Latn_XX	mvv_Latn
mwl	mwl_Latn_XX	mwl
mww	mww_Latn_XX	mww
my	mya_Mymr_MM	mya
myv	myv_Cyrl_RU	myv
na	nau_Latn_NR	nau
nah	nah_Latn_XX	nah_Latn
nan	nan_Hans_CN	nan
nb	nob_Latn_NO	nob
nch	nch_Latn_XX	nch
nds	nds_Latn_DE	nds
new	new_Deva_XX	new
ngt	ngt_Latn_XX	ngt_Latn
ngu	ngu_Latn_XX	ngu_Latn
niu	niu_Latn_NU	niu
nl	nld_Latn_NL	nld
nlv	nlv_Latn_XX	nlv_Latn
nn	nno_Latn_NO	nno
nog	nog_Cyrl_XX	nog
non	non_Zyyy_XX	non
nov	nov_Latn_XX	nov_Latn
npi	npi_Deva_NP	npi
nst	nst_Latn_XX	nst_Latn
nus	nus_Latn_SS	nus
nv	nav_Latn_XX	nav
ny	nya_Latn_MW	nya
nys	nys_Latn_XX	nys_Latn
oar	oar_Hebr_XX	oar_Hebr
oc	oci_Latn_FR	oci
ofs	ofs_Latn_XX	ofs_Latn
oj	oji_Latn_XX	oji_Latn
ood	ood_Latn_XX	ood_Latn
or	ori_Orya_IN	ori
orv	orv_Cyrl_XX	orv_Cyrl
os	oss_Cyrl_GE	oss
osp	osp_Latn_XX	osp_Latn
osx	osx_Latn_XX	osx_Latn
ota	ota_Arab_XX	ota_Arab
otk	otk_Orkh_XX	otk_Orkh
pa	pan_Guru_XX	pan_Guru
pag	pag_Latn_PH	pag
pal	pal_Zyyy_XX	pal
pam	pam_Latn_PH	pam
pap	pap_Latn_XX	pap
pau	pau_Latn_PW	pau
pcd	pcd_Latn_XX	pcd
pdc	pdc_Latn_XX	pdc
pes	pes_Arab_IR	pes
pfl	pfl_Latn_XX	pfl
phn	phn_Phnx_XX	phn_Phnx
pi	pli_Zyyy_XX	pli
pl	pol_Latn_PL	pol
pms	pms_Latn_XX	pms
pnb	pnb_Arab_PK	pnb
ppl	ppl_Latn_XX	ppl_Latn
prg	prg_Latn_XX	prg_Latn
ps	pus_Arab_AF	pus
pt	por_Latn_PT	por
qu	que_Latn_PE	que
quc	quc_Latn_GT	quc
qxq	qxq_Arab_XX	qxq_Latn
qya	qya_Latn_XX	qya_Latn
rap	rap_Latn_XX	rap
rel	rel_Latn_XX	rel_Latn
rif	rif_Latn_MA	rif_Latn
rm	roh_Latn_CH	roh
rn	run_Latn_BI	run
ro	ron_Latn_RO	ron
rom	rom_Latn_XX	rom
ru	rus_Cyrl_RU	rus
rue	rue_Cyrl_XX	rue
rw	kin_Latn_RW	kin
ryu	ryu_Zyyy_XX	ryu
sa	san_Deva_IN	san_Deva
sah	sah_Cyrl_RU	sah
sc	srd_Latn_IT	srd
scn	scn_Latn_IT	scn
sco	sco_Latn_GB	sco
sd	snd_Arab_XX	snd_Arab
sdh	sdh_Arab_IR	sdh
se	sme_Latn_NO	sme
sg	sag_Latn_CF	sag
sgs	sgs_Latn_XX	sgs
shs	shs_Latn_XX	shs_Latn
shy	shy_Latn_XX	shy_Latn
si	sin_Sinh_LK	sin
sjn	sjn_Latn_XX	sjn_Latn
sl	slv_Latn_SI	slv
sm	smo_Latn_XX	smo
sma	sma_Latn_SE	sma
sn	sna_Latn_ZW	sna
so	som_Latn_SO	som
sq	sqi_Latn_AL	sqi
sr	srp_Cyrl_XX	srp_Cyrl
ss	ssw_Latn_ZA	ssw
st	sot_Latn_ZA	sot
stq	stq_Latn_XX	stq
su	sun_Latn_ID	sun
sux	sux_Xsux_XX	sux_Xsux
sv	swe_Latn_SE	swe
swg	swg_Latn_XX	swg
swh	swh_Latn_TZ	swh
syc	syc_Syrc_XX	syc_Syrc
ta	tam_Taml_IN	tam
te	tel_Telu_IN	tel
tet	tet_Latn_TL	tet
tg	tgk_Cyrl_TJ	tgk_Cyrl
th	tha_Thai_TH	tha
thv	thv_Latn_NE	thv
ti	tir_Ethi_ET	tir
tig	tig_Ethi_ER	tig
tk	tuk_Latn_TM	tuk_Latn
tkl	tkl_Latn_TK	tkl
tl	tgl_Latn_XX	tgl_Latn
tlh	tlh_Latn_XX	tlh_Latn
tly	tly_Latn_XX	tly_Latn
tmr	tmr_Hebr_XX	tmr_Hebr
tmw	tmw_Latn_MY	tmw_Latn
tn	tsn_Latn_ZA	tsn
to	ton_Latn_TO	ton
toi	toi_Latn_XX	toi_Latn
toki	toki_Latn_XX	toki_Latn
tpi	tpi_Latn_PG	tpi
tpw	tpw_Latn_XX	tpw_Latn
tr	tur_Latn_TR	tur
ts	tso_Latn_ZA	tso
tt	tat_Cyrl_RU	tat
tts	tts_Thai_TH	tts
tvl	tvl_Latn_TV	tvl
ty	tah_Latn_PF	tah
tyv	tyv_Cyrl_RU	tyv
tzl	tzl_Latn_XX	tzl_Latn
udm	udm_Cyrl_RU	udm
ug	uig_Arab_CN	uig_Arab
uk	ukr_Cyrl_UA	ukr
umb	umb_Latn_AO	umb
ur	urd_Arab_PK	urd
urh	urh_Latn_XX	urh_Latn
uz	uzb_Latn_XX	uzb_Latn
vec	vec_Latn_XX	vec
vep	vep_Latn_XX	vep
vi	vie_Latn_VN	vie
vo	vol_Latn_XX	vol_Latn
vro	vro_Latn_EE	vro
wa	wln_Latn_BE	wln
war	war_Latn_PH	war
wo	wol_Latn_SN	wol
wuu	wuu_Hans_CN	wuu
xal	xal_Cyrl_XX	xal
xh	xho_Latn_ZA	xho
xmf	xmf_Geor_XX	xmf
xqa	xqa_Latn_XX	xqa_Latn
yi	yid_Hebr_XX	yid
yo	yor_Latn_NG	yor
yua	yua_Latn_XX	yua
yue	yue_Hans_XX	yue_Hans
zgh	zgh_Tfng_MA	zgh
zlm	zlm_Latn_MY	zlm_Latn
zsm	zsm_Latn_MY	zsm_Latn
zu	zul_Latn_ZA	zul
zza	zza_Latn_TR	zza
